11111111111111111111111111111111
10000110000000011000110000000001
10000333000000011000333000000001
10000110000000011000110000000001
10200110000000011000110000000001
10000333000000011000110000000001
10000110000000011000110000000001
10000110000000011000110000000001
10000110000200033300112000000001
10000113131111111002110000000001
10000113131111111000110000000001
10000333030000011000110000000001
10000110000000011133110000000001
10000110000000011133111331111311
11113110000000011033111331111311
11113110020000033300110330000301
10003333000000033300110000000001
10200333000000011000333000000001
10000110000000011000110000002001
10000333000000011000110000000001
10000110000000011000110000000001
10000110000000011000110000000001
10000333000000011000110000000001
10000333000000011002110000000001
11111111111111111111111111111111